11111111111111
10010000000011
11100111110011
1P00111EC00011
11111111111111
11111111111111
