11111111111111
1CCCCCCCCCCCC1
11111111111101
10000000000001
10000000000001
10000000000001
10000000000001
1P00000EC00001
11111111111111
